***********
*#*#*#*#*#*
****#**M***
**W#***M**#
*****m*M***
#**********
*#*#*#*#*#*
***S*******
*#******M**
***********
*h*********
***********