***********
*#*#*#*#*#*
****#******
**W#******#
*****m*****
#**********
*#*#*#*#*#*
***S*******
*#******M**
***********
*h*********
***********